XXXXXXXXXXXXXXXXXXXXXXXXXXXXX
S  X            X       X   X
X XXX X XXX XXX XXXXX X X X X
X     X X   X         X   X X
XXXXXXXXX XXXXXXXXXXXXXXXXXXX
X       X X X     X         X
XXXX XXXX XXX XXX X X XXXXX X
X         X   X X X X     X X
X X XXXXXXX XXXXX X XXXXXXX X
X X X         X X   X   X   X
X XXX X XXXXXXX XXXXXXX X XXX
X     X                 X   E
XXXXXXXXXXXXXXXXXXXXXXXXXXXXX
